##########
#b  X   X#
#        #
#   C    #
#        #
#  S   # #
#  C   #C#
#  s  O# #
#  X   #E#
##########
